1 13 31
###############################
#p     ** *  1 * 2 *  * * *   #
# # #  # #   #*#  *#*  # ***# #
#  x*     ***  *  1   * 2 * * #
# # # # # #*# # #*#*# # # # #*#
#f         x **  *  *   1     #
# # #  # # *** ## #  # **# f b#
#*  *      *  *      *        #
# # # # #*# # # #*#*# # s # # #
#*    **  *       *           #
# #*# f # *# b # # # #s*# * * #
#           *   *  *          #
###############################