1 13 31
###############################
#p     ** *    *   *  * * *   #
#     #*# # #*#*# # # #*# 4*# #
# x *     ***  *      *   * * #
# # # #1# #*# # #*#*# # # # #*#
#f           **  *  *         #
# # # # #   # # # #*# #*  # # #
#*  *      *  *      *        #
# # # # #*# # # #*#*# # s # # #
#*    **  *   x   *           #
# #*# f # # # # #*# b # # # # #
#           * 5 *  *          #
###############################